*******
* * * *
*** ***
* *  **
***0***
