*******
* * * *
*** **
* *  *
*******
